DDHHDTDHHDD
FDDHHDHHDDF
FFDDHHHDDFF
RFFDIHrDFFR
FFDDHHHDDFF
FDDHHDHHDDF
DDHHDTDHHDD