IIIIIIIIIII
HhHhHhHhHhH
hHhHhHhHhHh
HhhIIHIIhhH
hHhHhHhHhHh
HhHhHhHhHhH
IIIIIIIIIII